6111111111111113
5111111361111114
0000000220000000
0000000220000000
0000000540000000