611111111111111111111111111111111111111111111113
277777777777777777777777777777777777777777777772
277777777777777777777777761111111111111111111372
277777777777777777777777720000000000000000000272
277777777777777777777777751111111111111111111472
277777777777777777777777777777777777777777777772
277777777777777777777777777777777777777777777772
277777777777777777777777777777777777777777777772
277777777777777777777777777777777777777777777772
277777777777777777777777777777777777777777777772
277777777777777777777777777777777777777777777772
277777777777777777777777777777777777777777777772
277777777777777777777777777777777777777777777772
277777777777777777777777777777777777777777777772
277777777777777777777777777777777777777777777772
277777777777777777777777777777777777777777777772
277777777777777777777777777777777777777777777772
277777777777777777777777777777777777777777777772
277777777777777777777777777777777777777777777772
277777777777777777777777777777777777777777777772
277777777777777777777777777777777777777777777772
277777777777777777777777777777777777777777777772
277611111111111111111113777777777777777777777772
277200000000000000000002777777777777777777777772
277511111111111111111114777777777777777777777772
277777777777777777777777777777777777777777777772
511111111111111111111111111111111111111111111114