611111111111111111111111111111111111111111111113
277777777777777777777777777777777777777777777772
277777777777777777763777777763777777777777777772
277777777777777777722777777722777777777777777772
277777777777777777722777777722777777777777777772
277777777777777777722777777722777777777777777772
277777777777777777725113761142777777777777777772
277777777777777777726114751132777777777777777772
277777777777777777722777777722777777777777777772
277777777777777777722777777722777777777777777772
277777777777777777722776137722777777777777777772
277777777777777777754772727754777777777777777772
277777777777777777777772727777777777777777777772
277777777777777777763775147763777777777777777772
277777777777777777722777777722777777777777777772
277777777777777777722777777722777777777777777772
277777777777777777722761113722777777777777777772
277777777777777777754751114754777777777777777772
277777777777777777777777777777777777777777777772
277777777777777777777777777777777777777777777772
277777777777777777777777777777777777777777777772
277777777777777777777777777777777777777777777772
277777777777777777777777777777777777777777777772
277777777777777777777777777777777777777777777772
277777777777777777777777777777777777777777777772
277777777777777777777777777777777777777777777772
511111111111111111111111111111111111111111111114
