611111111111111111111111111111111111111111111113
277777777777777777777777777777777777777777777772
277777777777777777777777777763777777777777777772
277777777777777777777777770022000000000000000772
277777777777777777777777777722777777777777777772
277777777777777777777777777722777777777777777772
277777777777777777777777761142777777777777777772
277777777777777777777777751132777777777777777772
277777777777777777777777777722777777777777777772
277777777777777777777777777722777777777777777772
277777777777777777777777777722777777777777777772
277777777777777777777777777754777777777777777772
277777777777777777777777777777777777777777777772
277777777777777777777777777763777777777777777772
277777777777777777777777777722777777777777777772
277777777777777777777777777722777777777777777772
277777777777777777777777777722777777777777777772
277777777777777777777777777754777777777777777772
277777777777777777777777777777777777777777777772
277777777777777777777777777777777777777777777772
277777777777777777777777777777777777777777777772
277777777777777777777777777777777777777777777772
277777777777777777777777777777777777777777777772
277700000000000000000007777777777777777777777772
277777777777777777777777777777777777777777777772
277777777777777777777777777777777777777777777772
511111111111111111111111111111111111111111111114
