61111111111111111111111111111111111111111111111113
20000000000000000000000000000000000000000000000002
20000000000000000000000000000000000000000000000002
20000000000000000000000000000000000000000000000002
20000600000000000000000000000000000000000000000002
20000600000000000000000000000000000000000100000002
20002400000000000000000000000000000000000000000002
20000000000002000000000000000000000002000000000002
20002000000000000000000000000000000000000400040002
20000000000000000000000000000000000000000000000002
20000000000000000000000000000000040000000400000002
20000000000000000000010000000000000000000000000002
20000200000000000000000000000000000000000000000002
20000000002001000000000000000000000000400040010002
20000000000000000000000000000000000000000030000002
20000000000000000000000000000004000000000000030002
20000000000000000000000000000000000000000400400002
20000000000000000000000000000000000000000000000002
20000000000000000000000000060000000004000000000002
20000000000000000000000000000030000000000000000002
20000000000001000000000000000000000000000000000002
20000000000000000000000005000000000000000000000002
20000000000000000000040000000000000040000000000002
20000000000000000000000000000000000000000000000002
20000000000000000000000000000000000000004000000002
20000000000000000000000000000000400004000000000002
20000000000000000000000000000000000000000040000002
20000000000000000000000000000000000000000000000002
20000000000000000000000000000000000000000000000002
51111111111111111111111111111111111111111111111114
