6111111111111361111111111113
2777777777777227777777777772
2761137611137227611137611372
2720027200027227200027200272
2751147511147547511147511472
2777777777777777777777777772
2761137637611111137637611372
2751147227511361147227511472
2777777227777227777227777772
5111137251130220611427611114
0000027261140540511327200000
0000027220000000000227200000
1111147540611001130547511111
0000007000200000020007000000
1111137630511111140637611111
0000027220000000000227200000
0000027220611111130227200000
6111147540511361140547511113
2777777777777227777777777772
2761137611137227611137611372
2751327511147547511147261472
2777227777777777777777227772
5137227637611111137637227614
6147547227511361147227547513
2777777227777227777227777772
2761111451137227611451111372
2751111111147547511111111472
2777777777777777777777777772
5111111111111111111111111114
