6111111111111111111111111113
2777777777777777777777777772
2777777777777777777777777772
2777777777777777777777777772
2777777777777777777777777772
2777777777777777777777777772
2777777777777777777777777772
2777777777777777777777777772
2777777777777777777777777772
2777777777777777777777777772
2777777777777777777777777772
2777777777777777777777777772
2777777777777777777777777772
2777777777777777777777777772
2777777777777777777777777772
2777777777777777777777777772
2777777777777777777777777772
2777777777777777777777777772
2777777777777777777777777772
2777777777777777777777777772
2777777777777777777777777772
2777777777777777777777777772
2777777777777777777777777772
2777777777777777777777777772
2777777777777777777777777772
2777777777777777777777777772
2777777777777777777777777772
2777777777777777777777777772
5111111111111111111111111114
