061111111111113611111111111130
027777777777772277777777777720
027611376111372276111376113720
027200272000272272000272002720
027511475111475475111475114720
027777777777777777777777777720
027611376376111111376376113720
027511472275113611472275114720
027777772277772277772277777720
051111372511302206114276111140
000000272611405405113272000000
000000272200000000002272000000
011111475406110011305475111110
090000070002000000200070000090
011111376305111111406376111110
000000272200000000002272000000
000000272206111111302272000000
061111475405113611405475111130
027777777777772277777777777720
027611376111372276111376113720
027513275111475475111472614720
027772277777777777777772277720
051372276376111111376372276140
061475472275113611472275475130
027777772277772277772277777720
027611114511372276114511113720
028511111111475475111111114820
027777777777777777777777777720
051111111111111111111111111140