61111111111111111111111111111111111111111111111113
20000000000000000000000000000000000000000000000002
20000000000000000000000000000000000000000000000002
20000000000000000000000000000000000000000000000002
20000000000000000000000000000000000000000000000002
20000000000000000000000000000000000000000000000002
20000000000000000000000000000000000000000000000002
20000000000000000000000000000000000000000000000002
20000000000000000000000000000000000000000000000002
20000000000000000000000000000000000000000000000002
20000000000000000000000000000000000000000000000002
20000000000000000000000000000000000000000000000002
20000000000000000000000000000000000000000000000002
20000000000000000000000000000000000000000000000002
20000000000000000000000000000000000000000000000002
20000000000000000000000000000000000000000000000002
20000000000000000000000000000000000000000000000002
20000000000000000000000000000000000000000000000002
20000000000000000000000000000000000000000000000002
20000000000000000000000000000000000000000000000002
20000000000000000000000000000000000000000000000002
20000000000000000000000000000000000000000000000002
20000000000000000000000000000000000000000000000002
20000000000000000000000000000000000000000000000002
20000000000000000000000000000000000000000000000002
20000000000000000000000000000000000000000000000002
20000000000000000000000000000000000000000000000002
20000000000000000000000000000000000000000000000002
20000000000000000000000000000000000000000000000002
51111111111111111111111111111111111111111111111114
