611111111111111111111111111111111111111111111113
200000000000000000000000000000000000000000000002
200000000000000000000000061111111111111111111302
200000000000000000000000020000000000000000000202
200000000000000000000000051111111111111111111402
200000000000000000000000000000000000000000000002
200000000000000000000000000000000000000000000002
200000000000000000000000000000000000000000000002
200000000000000000000000000000000000000000000002
200000000000000000000000000000000000000000000002
200000000000000000000000000000000000000000000002
200000000000000000000000000000000000000000000002
200000000000000000000000000000000000000000000002
200000000000000000000000000000000000000000000002
200000000000000000000000000000000000000000000002
200000000000000000000000000000000000000000000002
200000000000000000000000000000000000000000000002
200000000000000000000000000000000000000000000002
200000000000000000000000000000000000000000000002
200000000000000000000000000000000000000000000002
200000000000000000000000000000000000000000000002
200000000000000000000000000000000000000000000002
200611111111111111111113000000000000000000000002
200200000000000000000002000000000000000000000002
200511111111111111111114000000000000000000000002
200000000000000000000000000000000000000000000002
511111111111111111111111111111111111111111111114